BALL	B AO L
BOOKSHELF	B UH K SH EH L F
BOXES	B AA K S AH Z
BOXES(2)	B AA K S IH Z
CAN	K AE N
CAN(2)	K AH N
FOR	F AO R
FOR(2)	F ER
FOR(3)	F R ER
GO	G OW
ME	M IY
NAVIGATE	N AE V AH G EY T
OVER	OW V ER
READY	R EH D IY
THANK	TH AE NG K
THE	DH AH
THE(2)	DH IY
TO	T UW
TO(2)	T IH
TO(3)	T AH
WHEEL	W IY L
WHEEL(2)	HH W IY L
YOU	Y UW
