A	AH
A(2)	EY
ARE	AA R
ARE(2)	ER
CENTER	S EH N T ER
CENTER(2)	S EH N ER
COOL	K UW L
GAME	G EY M
HELLO	HH AH L OW
HELLO(2)	HH EH L OW
LET	L EH T
ME	M IY
OK	OW K EY
ON	AA N
ON(2)	AO N
PHOTO	F OW T OW
PLAY	P L EY
PLEASE	P L IY Z
SIT	S IH T
SO	S OW
TAKE	T EY K
THANK	TH AE NG K
THE	DH AH
THE(2)	DH IY
US	AH S
US(2)	Y UW EH S
WITH	W IH DH
WITH(2)	W IH TH
YOU	Y UW
